
XXX  XX    XXXXXX       
                            
          GGGGGGG            
     P                       
                 
                           XXXXXXXXXXXXXXXXXXXXXXXXXXXXXXXXXXXx 
                        
                                                                          XXXXXXXXXXX
 GGGGGGGGG             
                               
 XXXXXXXXXXXXXXXXXXXX     XXXXXX                              XXXXXXXXXXX         XXXXXXXXXXX
 XXXXXXXXXXX            
XXXXXXXXXXX                                XXXXXXXXXXXXXXXXXXXXXXXXXXXXXXXXXXXXXXXXXXXX
 XXXXXXXXXXX                                XXXXXXXXXXXXXXXXXXXXXXXXXXXXXXXXXXXXXXXXXXXX
 XXXXXXXXXXX            
  XXXXXXXXXXXXXXXXXXXXXX            
     XXXXXXXXXXX XXXXXXXXXXXXXXXXXXXXXXXXXXXXXXXXXXXXXXXXXXXX           
     XXXXXXXXXXXXXXXXXXXXXXXXXXXXXXXXXXXXXXXXXXXX            
     XXXXXXXXXXXXXXXXXXXXXX XXXXXXXXXXXXXXXXXXXXXX           
   XXXXXXXXXXXXXXXXXXXXXX            
     XXXXXXXXXXXXXXXXXXXXXX            
     XXXXXXXXXXXXXXXXXXXXXXXXXXXXXXXXX            
     XXXXXXXXXXX            
     XXXXXXXXXXX            
     XXXXXXXXXXX        