
XXX  XX    XXXXXX       
                            
          GGGGGGG            
     P                       
                 
                          GGGGGGGGGGGXXXXXXXXXXXXXXXXXXXXXXXXXx 
                        
                                                                          XXXXXXXXXXX
 GGGGGGGGG             
                               
 XXGGGGGGGGGGGGGGGXXXXX     GGGGGGG                              XXXXXXXXXXX         XXXXXXXXXXX
 GGGGGGGGGGGGGGGGGGGGGGGGGGG            
XXXXXXXXXXX                                XXXXXXXXXXXXXXXXXXXXXXXXXXXXXXXXXXXXXXXXXXXX
 XXXXXXXXXXX                                XXXXXXXXXXXXXXXXXXXXXXXXXXXXXXXXXXXXXXXXXXXX
 XXXXXXXXXXX            
  XXXXXXXXXXXXXXXXXXXXXX            
     XXXXXXXXXXX XXXXXXXXXXXXXXXXXXXXXXXXXXXXXXXXXXXXXXXXXXXX           
     XXXXXXXXXXXXXXXXXXXXXXXXXXXXXXXXXXXXXXXXXXXX            
     XXXXXXXXXXXXXXXXXXXXXX XXXXXXXXXXXXXXXXXXXXXX           
   XXXXXXXXXXXXXXXXXXXXXX            
     XXXXXXXXXXXXXXXXXXXXXX            
     XXXXXXXXXXXXXXXXXXXXXXXXXXXXXXXXX            
     XXXXXXXXXXX            
     XXXXXXXXXXX            
     XXXXXXXXXXX        